1111111111111111111
100C0E0000C00000P01
1111111111111111111
