1111111111111111111
1P0C00E00C000000001
1111111111111111111
