111111111111111111111111111111111111
1P00000000000100000000000000000000E1
101111101111101111101111101111101111
100000101000000000000000001000000001
101111101011111011110111101111101111
100000000000000000000000000000000001
111111101111101111101111101111101111
1C000010000000C000000000000000C00001
101111101011111011110111101111101111
100000000000000000000000000000000001
111111101111101111101111101111101111
1C000010000000C000000000000000C00001
101111101011111011110111101111101111
100000001000000000000000001000000001
101111101011111011110111101111101111
1C000000000000000000000000000000C001
111111101111101111101111101111101111
1C000010000000C000000000000000C00001
101111101011111011110111101111101111
100000000000000000000000000000000001
101111101111101111101111101111101111
1C000000000000C000000000000000C00001
101111101111101111101111101111101111
100000000000000000000000000000000001
111111111111111111111111111111111111
